00,00,00,00,00,00,00,00,00,00,00,00,00,00,00,00,00,00,00,00,00,00,00,00,00,00,00,00,00,00,00,00,00,00,00,00,00,00,00,00,00,00,00,00,00,00,00,00,00,00,00,00,00,00,00
00,00,00,00,00,00,00,00,00,00,00,00,00,00,00,00,00,00,00,00,00,00,00,00,00,00,00,00,00,00,00,00,00,00,00,00,00,00,00,00,00,00,00,00,00,00,00,00,00,00,00,00,00,00,00
00,00,00,00,00,00,00,00,00,00,00,00,00,00,00,00,00,00,00,00,00,00,00,00,00,00,00,00,00,00,00,00,00,00,00,00,00,00,00,00,00,00,00,00,00,00,00,00,00,00,00,00,00,00,00
00,00,00,00,00,00,00,00,00,00,00,00,00,00,00,00,00,00,00,00,00,00,00,00,00,00,00,00,00,00,00,00,00,00,00,00,00,00,00,00,00,00,00,00,00,00,00,00,00,00,00,00,00,00,00
00,00,00,00,00,00,00,00,00,00,00,00,00,00,00,00,00,00,00,00,00,00,00,00,00,00,00,00,00,00,00,00,00,00,00,00,00,00,00,00,00,00,00,00,00,00,00,00,00,00,00,00,00,00,00
00,00,00,00,00,00,00,00,00,01,02,03,00,00,00,00,01,02,03,00,00,00,00,01,02,03,00,00,00,00,01,02,03,00,00,00,00,01,02,03,00,00,00,00,01,02,03,00,00,00,00,00,00,00,00
00,00,00,00,00,00,00,00,04,05,06,07,08,00,00,04,05,06,07,08,00,00,04,05,06,07,08,00,00,04,05,06,07,08,00,00,04,05,06,07,08,00,00,04,05,06,07,08,00,00,00,00,00,00,00
00,00,00,00,00,00,00,09,10,11,12,13,14,00,09,10,11,12,13,14,00,09,10,11,12,13,14,00,09,10,11,12,13,14,00,09,10,11,12,13,14,00,09,10,11,12,13,14,00,00,00,00,00,00,00
00,00,00,00,00,00,00,15,16,17,18,19,20,00,15,16,17,18,19,20,00,15,16,17,18,19,20,00,15,16,17,18,19,20,00,15,16,17,18,19,20,00,15,16,17,18,19,20,00,00,00,00,00,00,00
00,00,00,00,00,00,00,00,00,22,23,00,00,00,00,00,22,23,00,00,00,00,00,22,23,00,00,00,00,00,22,23,00,00,00,00,00,22,23,00,00,00,00,00,22,23,00,00,00,00,00,00,00,00,00
00,00,00,00,00,24,25,26,26,26,26,26,26,26,26,27,28,26,27,28,26,27,28,26,27,28,26,27,28,26,27,28,26,27,28,26,26,26,26,26,26,26,27,28,26,27,28,26,29,30,00,00,00,00,00
00,00,00,00,00,00,25,26,26,26,26,26,26,26,26,27,28,26,27,28,26,27,28,26,27,28,26,27,28,26,27,28,26,27,28,26,26,26,26,26,26,26,27,28,26,27,28,26,29,00,00,00,00,00,00
00,00,00,00,00,00,00,00,00,00,00,00,00,00,00,00,00,00,00,00,00,00,00,00,00,00,00,00,00,00,00,00,00,00,00,00,00,00,00,00,00,00,00,00,00,00,00,00,00,00,00,00,00,00,00
00,00,00,00,00,00,00,00,00,00,00,00,00,00,00,00,00,00,00,00,00,00,00,00,00,00,00,00,00,00,00,00,00,00,00,00,00,00,00,00,00,00,00,00,00,00,00,00,00,00,00,00,00,00,00
00,00,00,00,00,00,00,00,00,00,00,00,00,00,00,00,00,00,00,00,00,00,00,00,00,00,00,00,00,00,00,00,00,00,00,00,00,00,00,00,00,00,00,00,00,00,00,00,00,00,00,00,00,00,00
00,00,00,00,00,00,00,00,00,00,00,00,00,00,00,00,00,00,00,00,00,00,00,00,00,00,00,00,00,00,00,00,00,00,00,00,00,00,00,00,00,00,00,00,00,00,00,00,00,00,00,00,00,00,00