00,00,00,00,00,00,00,00,00,00,00,00,00,00,00,00,00,00,00,00,00,00,00,00,00,00,00,00,00,00,00,00,00,00,00,00,00,00,00,00,00,00
00,00,00,00,00,00,00,00,00,00,00,00,00,00,00,00,00,00,00,00,00,00,00,00,00,00,00,00,00,00,00,00,00,00,00,00,00,00,00,00,00,00
00,00,00,00,00,00,00,00,00,00,00,00,00,00,00,00,00,00,00,00,00,00,00,00,00,00,00,00,00,00,00,00,00,00,00,00,00,00,00,00,00,00
00,00,00,00,00,00,01,02,03,00,00,00,00,01,02,03,00,00,00,00,01,02,03,00,00,00,00,01,02,03,00,00,00,00,01,02,03,00,00,00,00,00
00,00,00,00,00,04,05,06,07,08,00,00,04,05,06,07,08,00,00,04,05,06,07,08,00,00,04,05,06,07,08,00,00,04,05,06,07,08,00,00,00,00
00,00,00,00,09,10,11,12,13,14,00,09,10,11,12,13,14,00,09,10,11,12,13,14,00,09,10,11,12,13,14,00,09,10,11,12,13,14,00,00,00,00
00,00,00,00,15,16,17,18,19,20,00,15,16,17,18,19,20,00,15,16,17,18,19,20,00,15,16,17,18,19,20,00,15,16,17,18,19,20,00,00,00,00
00,00,00,21,21,21,22,23,21,21,21,21,21,22,23,21,21,21,21,21,22,23,21,21,21,21,21,22,23,21,21,21,21,21,22,23,21,21,21,21,00,00
00,00,24,25,26,26,26,26,26,26,26,26,27,28,26,27,28,26,27,28,26,27,28,26,27,28,26,27,28,26,27,28,26,26,26,26,26,26,29,30,00,00

0,0,0,0,0,0,0,0,0,0,0,0,0,0,0,0,0,0,0,0,0,0,0,0,0,0,0,0,0,0,0,0,0,0,0,0,0,0,0,0,0,0
0,0,0,0,0,0,0,0,0,0,0,0,0,0,0,0,0,0,0,0,0,0,0,0,0,0,0,0,0,0,0,0,0,0,0,0,0,0,0,0,0,0
0,0,0,0,0,0,0,0,0,0,0,0,0,0,0,0,0,0,0,0,0,0,0,0,0,0,0,0,0,0,0,0,0,0,0,0,0,0,0,0,0,0
0,0,0,0,0,0,0,0,0,0,0,0,0,0,0,0,0,0,0,0,0,0,0,0,0,0,0,0,0,0,0,0,0,0,0,0,0,0,0,0,0,0
0,0,0,0,0,0,0,0,0,0,0,0,0,0,0,0,0,0,0,0,0,0,0,0,0,0,0,0,0,0,0,0,0,0,0,0,0,0,0,0,0,0
0,0,0,0,0,0,0,0,0,0,0,0,0,0,0,0,0,0,0,0,0,0,0,0,0,0,0,0,0,0,0,0,0,0,0,0,0,0,0,0,0,0
0,0,0,0,0,0,0,0,0,0,0,0,0,0,0,0,0,0,0,0,0,0,0,0,0,0,0,0,0,0,0,0,0,0,0,0,0,0,0,0,0,0
0,0,0,0,0,0,0,0,0,0,0,0,0,0,0,0,0,0,0,0,0,0,0,0,0,0,0,0,0,0,0,0,0,0,0,0,0,0,0,0,0,0
0,0,0,1,1,1,1,1,1,1,1,1,1,1,1,1,1,1,1,1,1,1,1,1,1,1,1,1,1,1,1,1,1,1,1,1,1,1,1,0,0,0